AerospaceManufacturer	Group
AnatomicalStructure	Medical
Artist	Person
ArtWork	CreativeWorks
Athlete	Person
CarManufacturer	Group
Cleric	Person
Clothing	Product
Disease	Medical
Drink	Product
Facility	Location
Food	Product
HumanSettlement	Location
MedicalProcedure	Medical
Medication/Vaccine	Medical
MusicalGRP	Group
MusicalWork	CreativeWorks
ORG	Group
OtherLOC	Location
OtherPER	Person
OtherPROD	Product
Politician	Person
PrivateCORP	Group
PublicCORP	Group
Scientist	Person
Software	CreativeWorks
SportsGRP	Group
SportsManager	Person
Station	Location
Symptom	Medical
Vehicle	Product
VisualWork	CreativeWorks
WrittenWork	CreativeWorks